
abandoned	abandon
abbreviations	abbreviation
aborted	abort
absentees	absentee
abstracting	abstract
abstracts	abstract
abteilungen	abteilung
accepted	accept
accessions	accession
accidents	accident
accommodate	accommodation
accommodating	accommodation
accomodation	accommodation
accompaning	accompany
accompanying	accompany
accomplished	accomplish
accountants	accountant
accounting	account
accounts	account
accustomed	accustom
achievements	achievement
acknowledge	acknowledgement
acknowledgements	acknowledgement
acorns	acorn
act	action
acted	action
actes	acte
acting		act
actions	action
activités	activité
actors	actor
acts	action
additions	addition
addresses	address
addresss	address
adhesives	adhesive
administrators	administrator
admirals	admiral
admissions	admission
adopted	adopt
adopts	adopt
advances	advance
adventures	adventure
advertise	advertisement
advertising	advertisement
adviser	advisor
advisers	advisor
advising	advise
advisors	advisor
affaires	affaire
affairs	affair
agendas	agenda
agents	agent
ages	age
agreements	agreement
aiding		aid
aids	aid
aims	aim
airforces	airforce
airlines	airline
airplanes	airplane
airports	airport
airstrikes	airstrike
airways	airway
aktion	action
aktions	action
alarmed	alarm
alarming	alarm
albums	album
aliens	alien
alija	aliya
alijah	aliya
aliyah	aliya
alleys	alley
allies	allie
allocations	allocation
allowances	allowance
alternates	alternate
alternators	alternator
ambassadors	ambassador
americans	american
amis	ami
amsterdammers	amsterdammer
amts	amt
anchors	anchor
ancients	ancient
anecdotes	anecdote
angels	angel
angers	anger
animals	animal
annexes	annexe
annotations	annotation
announcements	announcement
answering	answer
answers	answer
anthems	anthem
antifascists	antifascist
antiisraeli	antiisrael
antijewish	antisemitic
antinazis	antinazi
antiques	antique
antirevolutienairen	antirevolutionary
antirevolutionaries	antirevolutionary
antisemistim	antisemitism
antisemites	antisemite
antizionists	antizionist
apartments	apartment
appeals	appeal
appended	append
appendices	appendice
apples	apple
appliances	appliance
applications	application
applying	apply
appointed	appoint
appointments	appointment
arabs	arab
architects	architect
archives	archiv
archives	archive
archivs	archiv
armaments	armament
armenians	armenian
armored	armor
arms	arm
arrangements	arrangement
arrested	arrest
arrestees	arrestee
articles	article
artisans	artisan
artists	artist
arts	art
asocials	asocial
aspects	aspect
aspiring	aspire
assasination	assassination
assassinate	assassination
assessors	assessor
assets	asset
assigned	assign
assignments	assignment
assimilationists	assimilationist
associations	association
assured	assure
attached	attach
attachés	attaché
attachments	attachment
attacks	attack
attempted	attempt
attending	attend
attentats	attentat
attorneys	attorney
auctions	auction
audits	audit
aufenthaltslagers	aufenthaltslager
authors	author
avants	avant
avowed	avow
awards	award
axes	axe
bachelors	bachelor
backgrounds	background
bags	bag
balances	balance
balkans	balkan
bankers	banker
banknotes	banknote
banks	bank
barracks	barrack
bars	bar
basements	basement
bases	base
baskets	basket
batallions	batallion
battalions	battalion
bayerns	bayern
beans	bean
bearings	bearing
bears	bear
bedsteads	bedstead
beers	beer
befehlshabers	befehlshaber
beggars	beggar
behaviors	behavior
belgiens	belgien
belongings	belonging
belorussians	belorussian
beloved	belove
belts	belt
benefits	benefit
bibles	bible
bibliotheques	bibliotheque
bicycles	bicycle
biographies	biographie
birds	bird
birthdates	birthdate
births	birth
biscuits	biscuit
bishops	bishop
bissschop	bishop
bissschops	bishop
blacks	black
blades	blade
blanks	blank
blocked	block
blocks	block
blocs	bloc
blogs	blog
bloods	blood
blueprints	blueprint
boards	board
boats	boat
bogers	boger
bohles	bohle
bolles	bolle
bols	bol
bolts	bolt
bombs	bomb
booklets	booklet
books	book
booksellers	bookseller
bookstores	bookstore
boots	boot
bottles	bottle
boys	boy
breaking	break
breathing	breath
breeders	breeder
breeds	breed
bridges	bridge
brigades	brigade
bringing	bring
broadcasting	broadcast
broadcasts	broadcast
broadsheets	broadsheet
brochures	brochure
brokered	broker
broking		broke
brothers	brother
brussels	brussel
brusssels	brussel
budgeting	budget
budgets	budget
buildings	building
bulletins	bulletin
burgers	burger
burned	burn
buying		buy
buys	buy
bylaws	bylaw
cabinets	cabinet
cables	cable
cahiers	cahier
calculations	calculation
calendars	calendar
calling		call
calls	call
campaigning	campaigne
camps	camp
canals	canal
candles	candle
canvass	canvas
captains	captain
cards	card
carers	carer
carnivals	carnival
carpathians	carpathian
carpets	carpet
carriages	carriage
carriers	carrier
carrots	carrot
carrying	carry
cars	car
carts	cart
cases	case
cashbooks	cashbook
castles	castle
catalog	catalogue
catalogs	catalogue
catalogues	catalogue
cataracts	cataract
catastrophe	disaster
catastrophic	disaster
catholics	catholic
catholiques	catholique
cats	cat
celebrate	celebration
celebrates	celebration
censored	censor
centavos	centavo
centers	center
centre	center
centres	center
ceramics	ceramic
cereals	cereal
certificates	certificate
certificats	certificat
chairpersons	chairperson
chairs	chair
chamberlains	chamberlain
chambers	chamber
changes	change
channels	channel
chapters	chapter
characteristics	characteristic
charges	charge
chartered	charter
charterers	charterer
charters	charter
charts	chart
chats	chat
cheats	cheat
checkers	checker
checking	check
checks	check
cheers	cheer
chefs	chef
chemicals	chemical
chemists	chemist
cherished	cherish
chiefs	chief
childrens	children
chimneys	chimney
chips	chip
chits	chit
christians	christian
chronicles	chronicle
churchills	churchill
ciculaires	ciculaire
cigarettes	cigarette
cigars	cigar
cinemas	cinema
circles	circle
circuits	circuit
circulars	circular
citizens	citizen
civils	civil
claims	claim
classifieds	classified
clearings	clearing
clerks	clerk
clippings	clipping
clips	clip
clogs	clog
clothes	clothe
clouds	cloud
clubs	club
cluttered	clutter
codes	code
coins	coin
colijns	colijn
collaborators	collaborator
collected	collect
collections	collection
collects	collect
colleges	college
colliers	collier
colonies	colonie
colored	color
colour	color
coloured	color
columns	column
combattants	combattant
comitees	comitee
commanders	commander
commanding	command
commandos	commando
commands	command
commemmorating	commemoration
comments	comment
commerce	trade
commissies	commissie
commissioners	commissioner
commited	commit
commitments	commitment
commons	common
communications	communication
communiqués	communiqué
communists	communist
communities	community
compagnie	compagie
compagnies	companie
compagnon	companion
compagnons	companion
companies	companie
compatriots	compatriot
complaints	complaint
components	component
compressed	compress
comrades	comrade
concepts	concept
concerned	concern
concerted	concert
conditions	condition
conducted	conduct
conferences	conference
conflicts	conflict
congratulations	congratulation
congres	congress
connect	connection
connected	connect
connections	connection
connects	connection
conseils	conseil
consequences	consequence
considerations	consideration
consisting	consist
consists	consist
constructed	construct
consulates	consulate
consultants	consultant
consulting	consult
consumers	consumer
consuming	consume
contacts	contact
containing	contain
contents	content
contested	contest
continue	continuation
continuing	continuation
contracting	contract
contracts	contract
contributions	contribution
controling	control
controlling	control
controls	control
conventions	convention
converted	convert
conveyors	conveyor
convoys	convoy
cools	cool
cooperating	cooperation
cooperatives	cooperative
coordinating	coordination
copes	cope
copie	copy
copies	copy
cops	cop
copying	copy
corned	corn
cornelis	corneli
cornets	cornet
corporations	corporation
corps	corp
corpses	corpse
corrected	correct
correspondents	correspondent
corresponding	correspond
corsets	corset
corvées	corvée
corvers	corver
cosmetics	cosmetic
costs	cost
cottages	cottage
councillor	councilor
councillors	councilor
councils	council
counseling	advise
counselling	advise
counters	counter
counts	count
couples	couple
coupons	coupon
couriers	courier
courses	course
courts	court
cousins	cousin
covered	cover
covers	cover
crackles	crackle
crafts	craft
cramped	cramp
cranes	crane
crans	cran
credentials	credential
creditors	creditor
crimes	crime
criminals	criminal
critiques	critique
croatians	croatian
crosses	crosse
crossings	crossing
crossroads	crossroad
cucumbers	cucumber
cues	cue
cuisines	cuisine
cultures	culture
curbs	curb
cures	cure
currants	currant
custodians	custodian
customs	custom
cyclists	cyclist
damages	damage
danes	dane
daniels	daniel
dated	date
days	day
dealings	dealing
declarations	declaration
declares	declare
decorates	decorate
decrees	decree
decs	dec
deeds	deed
defeated	defeat
defences	defence
defending	defend
degens	degen
degrading	degrade
delayed	delay
delegates	delegate
deletions	deletion
delivered	deliver
democrats	democrat
denominations	denomination
dentists	dentist
departed	depart
departments	department
deportaties	deportation
deportations	deportation
deport		deportation
deported	deportation
deportees	deportee
dépôts	dépôt
depressed	depress
depts	department
derivatives	derivative
descendants	descendant
deserters	deserter
deserving	deserve
designed	design
designing	design
destroy	destruction
detailed	detail
detailing	detail
details	detail
detentions	detention
deterdings	deterding
detergents	detergent
deteriorating	deteriorate
deutsches	deutsche
deutschlands	deutschland
developed	develop
developments	development
devices	device
diagrams	diagram
diamonds	diamond
dictators	dictator
dimensions	dimension
dioceses	diocese
diplomas	diploma
diplomats	diplomat
directed	direct
directions	direction
directives	directive
directories	directory
directors	director
disagreements	disagreement
disappeared	disappear
disappointed	disappoint
disasters	disaster
discussed	discuss
diseases	disease
diskussion	discussion
diskussionen	discussion
displays	display
distinctives	distinctive
distinguished	distinguish
distorted	distort
distorts	distort
distressed	distress
distribute	distribution
distributes	distribution
distributions	distribution
districts	district
disturbed	disturb
diving	dive
divisions	division
doctors	doctor
domains	domain
donate	donation
donations	donation
doomed	doom
dossiers	dossier
doubles	double
doublets	doublet
doubts	doubt
downgrading	downgrade
downsizing	downsize
drafted	draft
drafting	draft
drafts	draft
drained	drain
draining	drain
drains	drain
dramas	drama
dramatics	dramatic
drawing	design
drawings	drawing
dreaded	dread
dreams	dream
dressings	dressing
dried	dry
drinking	drink
drinks	drink
drives	drive
driving		drive
drowned	drown
dunes	dune
duplicates	duplicate
dvds	dvd
ears	ear
eaters	eater
economics	economic
edges	edge
editing	edit
editions	edition
editors	editor
educates	educate
educators	educator
eggs	egg
egodocuments	egodocument
ehrenpreiss	ehrenpreis
eichmanns	eichmann
elders	elder
elected	elect
elections	election
elektrizitäts	elektrizität
elements	element
embroidered	embroider
emigrants	emigrant
empires	empire
employed	employ
employees	employee
employers	employer
encouraging	encourage
endangered	endanger
engaging	engage
engelandvaarders	engelandvaarder
engineers	engineer
engines	engine
englisches	englische
enjoyed	enjoy
entrances	entrance
entrepreneurs	entrepreneur
entrusted	entrust
envelopes	envelope
environs	environ
epidemics	epidemic
episodes	episode
erfuhrt	erfurt
escapes	escape
established	establish
establishments	establishment
estates	estate
estonians	estonian
ethic	ethics
etrangers	etranger
etudes	etude
etuis	etui
eugenic	eugenics
europeans	european
evacuate	evacuation
evacuees	evacuee
evakuierung	evacuation
evakuierungs	evacuation
events	event
eventuality	event
everts	evert
evidences	evidence
exalted	exalt
excerpts	excerpt
exchanges	exchange
executions	execution
exemptions	exemption
exercises	exercise
exhibit	exhibition
exhibitions	exhibition
exhibits	exhibit
expanded	expand
expand	expansion
expands	expansion
expenditures	expenditure
experiences	experience
experiments	experiment
explosives	explosive
exporters	exporter
extended	extend
extinguishers	extinguisher
extracts	extract
extremes	extreme
extremists	extremist
fabrics	fabric
factors	factor
facts	fact
failed	fail
falsifications	falsification
falters	falter
families	familie
farmers	farmer
farmlands	farmland
farms	farm
fascists	fascist
fashioned	fashion
fathers	father
fats	fat
favors	favor
feared	fear
feathers	feather
features	feature
federations	federation
fees	fee
feldmeijers	feldmeijer
feldwirtschaftskommandos	feldwirtschaftskommando
fellowships	fellowship
fertilizers	fertilizer
festivals	festival
festungs	festung
fields	field
fighters	fighter
fights	fight
figures	figure
files	file
films	film
finances	finance
financials	financial
findings	finding
fines	fine
finished	finish
fixed	fix
flees	flee
flights	flight
floodings	flooding
florists	florist
flowers	flower
flugzeugs	flugzeug
focused	focus
folkerts	folkert
followers	follower
fols	fol
fonds	fond
foods	food
forces	force
forensics	forensic
forests	forest
forgings	forging
formed	form
forms	form
forverts	forvert
forwarded	forward
foundations	foundation
fragments	fragment
fried	fry
friends	friend
frieslands	friesland
frisians	frisian
fruits	fruit
fuels	fuel
fulfilled	fulfill
funds	fund
furnished	furnish
gardeners	gardener
gardens	garden
garments	garment
gased	gas
gates	gate
gebrs	gebr
geburts	geburt
geers	geer
gelders	gelder
geldings	gelding
generators	generator
genetics	genetic
gens	gen
georges	george
germans	german
gers	ger
gersons	gerson
ghettoes	ghetto
ghettos	ghetto
girls	girl
goods	good
governments	government
governors	governor
gowns	gown
grades	grade
grains	grain
grams	gram
granted	grant
grants	grant
grapes	grape
graphics	graphic
graves	grave
greeks	greek
greenhouses	greenhouse
greens	green
greetings	greeting
grenades	grenade
grounds	ground
grouped	group
growers	grower
guarantees	guarantee
guarded	guard
guardians	guardian
guards	guard
guidelines	guideline
guides	guide
guns	gun
gurs	gur
gymnastics	gymnastic
gymnasts	gymnast
hammered	hammer
happening	event
harvesting	harvest
headlines	headline
headquarters	headquarter
heads	head
heated	heat
heavens	heaven
hideen	hid
hiding	hid
holdings	holding
holidays	holiday
honours	honour
horticulturists	horticulturist
hostages	hostage
hoteliers	hotelier
hotels	hotel
housemates	housemate
houses	house
hunters	hunter
hussars	hussar
ideas	idea
identifications	identification
iiarticle	article
iiarticles	article
iilist	list
iilists	list
iiworks	work
iiwork	work
illustrations	illustration
illustrators	illustrator
illustriertes	illustrierte
immigrants	immigrant
immovables	immovable
impaired	impair
implement	implementation
implementing	implementation
imported	import
importers	importer
imports	import
impoverished	impoverish
indians	indian
industrialists	industrialist
industries	industrie
infants	infant
informations	information
informators	informator
informed	inform
informing	inform
informings	inform
inherited	inherit
initiators	initiator
inmates	inmate
inquarts	inquart
inserted	insert
inserts	insert
insoles	insole
installations	installation
installed	install
instantie	installation
instanties	installation
institutes	institute
institutions	institution
instituts	institut
instructions	instruction
instruments	instrument
intellectuals	intellectual
intended	intend
intentioned	intention
intercepted	intercept
interested	interest
interests	interest
internationales	internationale
internee	interne
internees	interne
internes	interne
interpreters	interpreter
interrogations	interrogation
interrupted	interrupt
interruptions	interruption
introductions	introduction
invalids	invalid
inventars	inventar
invented	invent
invoices	invoice
ironers	ironer
islanders	islander
islands	island
israelisches	israelische
israelis	israeli
israelitas	israelita
israélites	israélite
israelitisches	israelitische
issues	issue
jews	jew
journalists	journalist
journals	journal
journeys	journey
keeping	keep
ketubahs	ketubah
keys	key
keywords	keyword
kid	child
kids	child
killed	kill
killing	kill
kilometers	kilometer
kindertransports	kindertransport
kings	king
kiosks	kiosk
kommandos	kommando
kommissars	kommissar
konfessions	konfession
kontos	konto
konzentrationslagers	konzentrationslager
koreans	korean
kosaks	kosak
labourers	labourer
lages	lage
lakes	lake
lamentations	lamentation
landed	land
landes	lande
landscapes	landscape
lands	land
languages	language
lanterns	lantern
latvians	latvian
laws	law
lawsuits	lawsuit
lawyers	lawyer
layers	layer
leaders	leader
lead	lea
leaflets	leaflet
learned	learn
leaves	leave
lebens	leben
lecturers	lecturer
lectures	lecture
legations	legation
legions	legion
lessons	lesson
letters	letter
librarians	librarian
licences	licence
license	licence
licenses	licence
limited	limit
limits	limit
lines	line
listed	list
lithuaian	lithuanian
lithuaians	lithuanian
lithuanians	lithuanian
loaded	load
loans	loan
locked	lock
lodges	lodge
looked	look
lubricating	lubrication
lunatics	lunatic
lyons	lyon
lyrics	lyric
machineguns	machinegun
machines	machine
magnes	magne
mailing	mail
maintaining	maintenance
maintain	maintenance
manage	management
managements	management
managing	management
manifestos	manifesto
manuals	manual
manufacturers	manufacturer
manuscripts	manuscript
maps	map
marriages	marriage
martyrs	martyr
masons	mason
masters	master
materials	material
matters	matter
mayors	mayor
measures	measure
medals	medal
mediators	mediator
medicines	medicine
meetings	meeting
mentioned	mention
mimeographed	mimeograph
miners	miner
mines	mine
ministeriums	ministerium
ministers	minister
minutes	minute
mirrors	mirror
mocking	mock
modeling	model
models	model
modes	mode
monuments	monument
mortgages	mortgage
moslem	muslim
moslems	muslim
mothers	mother
motorcyclists	motorcyclist
motors	motor
mountains	mountain
mouvement	movement
mouvements	movement
movements	movement
mulders	mulder
munitions	munition
murdered	murder
museums	museum
musicians	musician
muslims	muslim
mutations	mutation
named	name
narrows	narrow
nationales	nationale
nationalists	nationalist
nationals	national
nationalsocialist	nazi
nationalsozialist	nazi
nations	nation
naziregime	nazism
naziregimes	nazism
nazis	nazi
neglected	neglect
neighbors	neighbor
newsletters	newsletter
newsmagazines	newsmagazine
news	new
newspapers	newspaper
norwegians	norwegian
noses	nose
notepads	notepad
notes	note
notices	notice
notifications	notification
nouvelles	nouvelle
numbered	number
numbers	number
nurses	nurse
nuts	nut
oats	oat
oberlandesgerichts	oberlandesgericht
objectives	objective
observations	observation
observed	observe
observer	observant
obstruct	obstruction
obtained	obtain
occupying	occupy
officers	officer
officials	official
oils	oil
olympics	olympic
ones	one
operating	operate
operations	operation
opposing	opose
ordered	order
organisations	organisation
organizations	organization
oriented	orient
orphans	orphan
owned	own
packages	package
packed	pack
pages	page
painted	paint
paints	paint
palaces	palace
pants	pant
papers	paper
paragraphs	paragraph
paratroopers	paratrooper
parents	parent
parks	park
partisans	partisan
partners	partner
parts	part
passers	passer
passports	passport
pastes	paste
patents	patent
patriots	patriot
patrols	patrol
patrons	patron
peasants	peasant
pensions	pension
peoples	people
periodicals	periodical
perished	perish
permits	permit
perpetrators	perpetrator
persecutions	persecution
persons	person
persuades	persuade
petitions	petition
pharmaceuticals	pharmaceutical
pharmacists	pharmacist
philips	philip
photographers	photographer
photos	photo
physicians	physician
physics	physic
pickets	picket
pickles	pickle
pictures	picture
pieces	piece
pieters	pieter
pigeons	pigeon
piles	pile
pilots	pilot
pioneers	pioneer
pipes	pipe
placards	placard
placements	placement
places	place
planes	plane
planted	plant
plants	plant
plumbers	plumber
poems	poem
pointed	point
points	point
poles	pole
polished	polish
politicals	political
politiques	politique
portas	porta
porters	porter
portraits	portrait
possessed	possess
postcards	postcard
potted	pott
powdered	powder
powers	power
practicals	practical
pras	pra
preparations	preparation
preperations	preperation
prices	price
priests	priest
princes	prince
principles	principle
printed	print
printers	printer
prints	print
prisoners	prisoner
prisons	prison
privates	private
prizes	prize
problemes	probleme
problems	problem
procedures	procedure
proceedings	proceeding
processed	process
proclaimed	proclaim
producers	producer
productions	production
products	product
professors	professor
programmes	programme
projected	project
protected	protect
protégés	protégé
protestants	protestant
protocols	protocol
provinces	province
provisions	provision
psalms	psalm
publications	publication
published	publish
publishers	publisher
purchase	buy
purchases	buy
purchasing	buy
purposes	purpose
quartered	quarter
quarters	quarter
questionnaires	questionnaire
questions	question
quotes	quote
rabbinics	rabbinic
rabbis	rabbi
rademakers	rademaker
radios	radio
raids	raid
rails	rail
railways	railway
rapids	rapid
rates	rate
rations	ration
reasoned	reason
rebels	rebel
reccolections	reccolection
receipts	receipt
receivables	receivable
received	receive
receives	receive
receiv	receive
recherches	recherche
recipients	recipient
recollections	recollection
recommend	advise
recommendation	advise
recommended	advise
reconstructed	reconstruct
recorded	record
records	record
rectors	rector
redeemed	redeem
referees	referee
references	reference
reflections	reflection
reformed	reform
reformers	reformer
reformiertes	reformierte
refrigerators	refrigerator
refugees	refugee
refusers	refuser
regarded	regard
regardings	regarding
regards	regard
regents	regent
regiments	regiment
regimes	regime
registered	register
registers	register
registrars	registrar
regulations	regulation
rehabilitations	rehabilitation
reichsbüros	reichsbüro
reichskommissariats	reichskommissariat
reichskommissars	reichskommissar
reichsmesseamts	reichsmesseamt
reifs	reif
reins	rein
reiss	reis
rejected	reject
relations	relation
relatives	relative
releases	release
remembered	remember
remonstrants	remonstrant
renewed	renew
renumbered	renumber
repeated	repeat
reported	report
reports	report
representatives	representative
representing	representation
reprinted	reprint
republicans	republican
requested	request
requests	request
requirements	requirement
researched	research
residents	resident
resignations	resignation
resistants	resistant
resorts	resort
resources	resource
respected	respect
respondents	respondent
restaurants	restaurant
restrained	restrain
restricted	restrict
results	result
retailers	retailer
retained	retain
retirees	retiree
returned	return
reviews	review
revisions	revision
rooms	room
rooted	root
rothschilds	rothschild
rounded	round
rows	row
rubens	ruben
rules	rule
rulings	ruling
rumors	rumor
russians	russian
safes	safe
sahers	saher
saints	saint
sales	sale
sanctions	sanction
sanders	sander
satellites	satellite
savings	saving
scattered	scatter
schedules	schedule
schippers	schipper
schlesingers	schlesinger
schools	school
sciences	science
scissors	scissor
scouts	scout
scraps	scrap
screenings	screening
scriptures	scripture
sealed	seal
seas	sea
secretaries	secretarie
sections	section
seeds	seed
selected	select
sentences	sentence
serbians	serbian
servicemens	servicemen
services	service
settings	setting
settlements	settlement
shattered	shatter
shelters	shelter
shirts	shirt
shocked	shock
shoes	shoe
shootings	shooting
signed	sign
sipos	sipo
sisters	sister
sites	site
sitters	sitter
sizes	size
skilled	skill
skins	skin
skirts	skirt
slagts	slagt
slaughterhouses	slaughterhouse
slaves	slave
sledges	sledge
slogans	slogan
slovaks	slovak
socialists	socialist
soldiers	soldier
sonderkommandos	sonderkommando
sonderreferates	sonderreferate
songs	song
sons	son
sorted	sort
sounds	sound
soviets	soviet
sparks	spark
speakers	speaker
specialists	specialist
specials	special
species	specie
specifics	specific
spices	spice
spirits	spirit
sports	sport
squadrons	squadron
stables	stable
stabs	stab
stacked	stack
stacks	stack
stained	stain
stains	stain
stakeholders	stakeholder
stakend	staken
stakes	stake
stalled	stall
stamped	stamp
stamps	stamp
standards	standard
stars	star
statements	statement
states	state
statistics	statistic
statutes	statute
stayed	stay
stays	stay
stones	stone
stores	store
stoves	stove
strafkommandos	strafkommando
strained	strain
straits	strait
strands	strand
streets	street
striped	strip
strokes	stroke
stuffed	stuff
subcamps	subcamp
sub-groups	sub-group
subjects	subject
submissions	submission
subscriptions	subscription
substances	substance
suburbs	suburb
successions	succession
summers	summer
summoned	summon
summons	summon
sundays	sunday
supplements	supplement
supports	support
suppressed	suppress
surgeons	surgeon
surrogates	surrogate
surrounded	surround
surroundings	surrounding
surveying	survey
surviving	survive
survivors	survivor
suspected	suspect
suspects	suspect
sustained	sustain
swabians	swabian
swallows	swallow
swans	swan
swarts	swart
swimming	swim
synagogues	synagogue
systems	system
tables	table
tablets	tablet
tailored	tailor
talented	talent
tales	tale
tangiers	tangier
tankers	tanker
targeted	target
targets	target
tasks	task
taxis	taxi
teachers	teacher
teams	team
tears	tear
technicians	technician
telegrams	telegram
telephones	telephone
temples	temple
terrors	terror
testaments	testament
tests	test
textbooks	textbook
textiles	textile
texts	text
theaters	theater
theatres	theater
theatre	theater
thinkers	thinker
thoughts	thought
threatening	threat
tickets	ticket
tiles	tile
times	time
timmers	timmer
tires	tire
tools	tool
topics	topic
tops	top
tours	tour
tracking	track
trademarks	trademark
traders	trader
trading		trade
trafficking	traffic
trails	trail
transcripts	transcript
transferring	transfer
transportation	transport
transporting	transport
traps	trap
travelers	traveler
travellers	traveler
traveller	traveler
treats	treat
trees	tree
trends	trend
trials	trial
tricked	trick
trolleys	trolley
troops	troop
trustees	trustee
tubes	tube
tucked	tuck
tugs	tug
tukums	tukum
turks	turk
twisted	twist
typewriters	typewriter
ukrainians	ukrainian
ukrianians	ukrainian
ukrianian	ukrainian
uniformed	uniform
uniforms	uniform
unites	unite
units	unit
valleys	valley
valuables	valuable
values	value
valves	valve
vegetables	vegetable
versions	version
vessels	vessel
veterans	veteran
victims	victim
villages	village
villes	ville
vineyards	vineyard
voltages	voltage
volumes	volume
volunteers	volunteer
walks	walk
wanderings	wandering
wanted	want
warriors	warrior
wars	war
wastes	waste
waterways	waterway
weakened	weaken
websites	website
webviews	webview
wessels	wessel
wheels	wheel
whites	white
wines	wine
wings	wing
wittness	witness
wooded	wood
worked	work
workers	worker
working	work
works	work
wounded	wound
writers	writer
writings	writing
years	year
zippered	zipper
zippers	zipper
zoals	zoal
